F 220,100,0
SO textures/wood1.xpm
WE textures/wood2.xpm
EA textures/wood3.xpm

C               225,30,0












NO textures/wood0.xpm











        1111111111111111111111111
        1000000000110000000000001
        1011000001110000000000001
        1001000000000000000000001
111111111011000001110000000000001
10000000001000001110111111111111
11110111111111011100000010001
1111011E111111011101000010001
11000000110101011100000010001
10000000000000001100000010001
10000000000000001101010010001
11000001110101111101111001111
11110111 1010101 101111010001
11111111 1111111 111111111111
11111111111111111111111111111