11111111111111111111111111111111
1111E111000000000000111111111111
11100000000000000001111111111111
11111111111100000000000000000001
111111111111111000C0000011111111
1111111111111111111111111P111111
11111111111100000001111111111111
10000000000000001111111110000001
11111111111111111111111111111111