NO ./textures_xpm/naturalbricks_hd_verydark.xpm
SO ./textures_xpm/naturalbricks_hd_middle.xpm
EA ./textures_xpm/naturalbricks_hd_middle.xpm
WE ./textures_xpm/naturalbricks_hd_middle.xpm

C 100,100,160
F 15,111,154

11111111111111111
10000000000000001
10100000100000101
10000000000000001
10001000100010001
10000000000000001
10101010N01010101
10000000000000001
10100000100001001
11111000000000001
11111111111111111