11111111111111111111111111111111111111
10000000010000011110000000010000000001
1100000010000000001000000110000000001
10000000010000000000000000010000000001
1000000000000000N000000000000000000001
10000000000000000000000000000000000001
10001000000010000000001000000010000001
10000000000000000000000000000000000001
10000000010000000000000000010000000001
11000000110000000010000001100000000001
10000000010000000000000000010000000001
10000000000000000000000000000000000001
10000000000000000000000000000000000001
10001000000010000000001000000010000001
10000000000000000000000000000000000001
11111111111111111111111111111111111111