NO ./textures/real_tex/fav1.xpm
SO ./textures/img1.xpm
EA ./textures/real_tex/fav3.xpm
WE ./textures/img2.xpm


F 220,100,0
C 51,255,255

        1111111111111111111111111
        1000000000110001001001001
        1011000000000010000100101
        1011000001110000101010001
        10110000011100N0010000001
        1011000001110000010000001
        1011000001110000010000001
        1011000001110000010000001
        1011000001110000010000001
        1111111111111111111111111

