11111111111111111111111111111111111111
10000000010000000000000000010000000001
110000001N0000000001000000100000000001
10000000010000000000000000010000000001
10000000000000000000000000000000000001
10000000000000000000000000000000000001
10001000000010000000001000000010000001
10000000000000000000000000000000000001
10000000010000000000000000010000000001
11000000100000000100000010000000000111
10000000010000000000000000010000000001
10000000000000000000000000000000000001
10000000000000000000000000000000000001
10001000000010000000001000000010000001
10000000000000000000000000000000000001
11111111111111111111111111111111111111