11111111111111111111
10000000111000000011
10110000000011000001
10010000111001000001
10000000001000000011
100000000p0100000001
10000000111000000011
10110000000011000001
10010000111001000011
11111111111111111111