11111111111111111111
10000000010000000001
110000001p10000000001
10000000010000000001
10000000000000000001
10000000000000000001
10001000000010000001
10000000000000000001
11111111111111111111